                        ##############################################
                        #......##....................................#
                        #......##....................................#
                        #.......##...................................#
                        #........#...................................#
                        #........##..................................#
                        #........##..................................#
                        #........##..................................#
                        #........#...................................#
                        #.......##.............####..................#
                        #......##.............######.................#
#########################......##............########................########################################################################
#...............................##...........###.....###....................................................................................#
#................................###.........###.......##...................................................................................#
#..................................##.........#.........##..................................................................................#
####................................###.......##.........##.................................................................................#
#..#######............................##.......##.........##.............#####.................................#######......................#
#.......####...........................##.......#..........#........########.#####............................############..................#
#.........##............................#.......#..........##......###..........####.......................####.........###.................#
#.........###...........................##......##.........###..###................###...................####............##.................#
#...........##..........................##.....###..........##.###...................###................###..............##.................#
#............#.........................##....#####..........#####........#######........###...........####................####..............#
#............#####.....................##..#####........................###...####.........####....#####....................########........#
#..............##############...........####............................##......###.........###########...........................###.......#
#...........................######......................................##........###............####...............................#.......#
#................................###....................................###........##............####...............................##......#
#..................................###...................................####.......##............###...............................##......#
#....................................###..................................####........##..........####.............................###......#
#......................................##########.........................#########....###.........#####.......................######.......#
#.........................................#######........................##########.....###..........###.......................#####........#
#........................................#######......................#############.......####.........###.....................####.........#
####################################.....#####......................##############......................####..................###...........#
                                   #.....####...........................##########........................####...............###............#
                                   #.....###............................########............................##............######............#
                                   #.....##............................######.........................................########.###.........###################
                                   #......###..........................#####.......................................#######......############.................#
                                   #........########..................####......................................................#########....................#
                                   #..............####................###..........................................................###.......................#
                                   #................#####............####....................#######.........................................................#
                                   #...................###...........###........................######.......................................................#
                                   #....................###.........####..........................##########.................................................#
                                   #.....................###........###.............................########################.................................#
                                   ###########...........###...........................................####################..................................#
                                             #...........###.................................................................................................#
                                             #............##.................................................................................................#
                                             #.............###............#######################............................................................#
                                             #...............##############.....................####......................................................>..#
                                             #.....................................................###.......................................................#
                                             #.......................................................###.....................................................#
                                             #################################################################################################################